53 37 37 37 69 37 37 37 37 37 37 37 37 37 37 37 37 37 37 45
49 20 04 04 04 04 04 04 04 04 04 04 04 04 04 04 04 04 12 41
49 16 00 12 04 00 22 260 0 16 08 00 144 8 00 20 04 00 08 41
49 16 00 08 00 00 16 128 0 18 10 00 16 136 0 18 14 00 08 41
49 18 02 02 02 02 02 02 02 02 02 02 02 02 02 02 02 02 10 41
49 33 33 33 33 33 33 33 33 33 33 33 33 33 33 33 33 33 33 41
49 20 04 04 04 04 12 33 33 20 12 33 33 20 04 04 04 04 12 41
49 16 00 00 02 02 10 33 33 16 08 33 33 18 02 02 00 00 08 41
49 16 00 08 33 33 33 33 33 16 08 33 33 33 33 33 16 00 08 41
49 16 00 08 33 33 33 33 33 16 08 33 33 33 33 33 16 00 08 41
49 18 02 10 33 20 04 04 04 00 00 04 04 04 12 33 18 02 10 41
49 33 33 33 33 18 02 02 02 02 02 02 02 02 10 33 33 33 33 41
49 33 33 33 33 33 33 33 33 33 33 33 33 33 33 33 33 33 33 41
49 20 04 04 12 33 33 33 33 33 33 33 33 33 33 20 04 04 12 41
49 16 00 00 08 33 20 06 14 33 33 22 06 12 33 16 00 00 08 41
49 16 00 00 08 33 24 33 33 33 33 33 33 24 33 16 00 00 08 41
49 16 00 02 10 33 24 33 33 33 33 33 33 24 33 18 02 00 08 41
49 16 08 33 33 33 18 06 06 06 06 06 06 10 33 33 33 16 08 41
49 16 08 33 33 33 33 33 33 33 33 33 33 33 33 33 33 16 08 41
49 16 08 33 33 22 06 06 06 04 04 06 06 06 14 33 33 16 08 41
49 18 10 33 33 33 33 33 33 16 08 33 33 33 33 33 33 18 10 41
81 33 33 33 22 06 04 12 33 16 08 33 20 04 04 14 33 33 33 73
49 33 33 33 33 33 18 08 33 16 08 33 16 00 08 33 33 33 33 41
49 22 06 04 12 33 33 24 33 18 10 33 16 00 08 33 20 04 12 41
49 33 33 16 08 33 33 26 33 33 33 33 18 02 10 33 16 02 10 41
49 33 33 16 08 33 33 33 33 33 33 33 33 33 33 33 24 33 33 41
22 14 33 18 10 33 28 33 22 06 04 06 14 33 28 33 26 33 22 14
49 33 33 33 33 33 24 33 33 33 24 33 33 33 24 33 33 33 33 41
49 22 06 06 06 06 02 06 14 33 26 33 22 06 02 06 06 06 14 41
51 35 35 35 35 35 35 35 35 35 35 35 35 35 35 35 35 35 35 43