53 39 39 39 71 39 39 39 39 39 39 39 39 39 39 39 39 39 39 45
57 00 00 00 00 00 00 00 00 00 00 00 00 00 00 00 00 00 00 57
57 00 00 12 04 00 20 260 0 16 08 00 144 8 00 20 04 00 00 57
57 00 00 08 00 00 20 128 0 18 10 00 16 136 0 18 14 00 00 57
57 00 00 00 00 00 00 00 00 00 00 00 00 00 00 00 00 00 00 57
49 39 39 39 39 39 39 37 37 39 39 37 37 39 39 39 39 39 39 41
57 00 00 00 00 00 00 49 41 00 00 49 41 00 00 00 00 00 00 57
57 00 00 00 00 00 00 49 41 00 00 49 41 00 00 00 00 00 00 57
57 00 00 00 53 37 37 33 41 00 00 49 33 37 37 45 00 00 00 57
57 00 00 00 49 35 35 35 43 00 00 51 35 35 35 41 00 00 00 57
57 00 00 00 57 00 00 00 00 00 00 00 00 00 00 57 00 00 00 57
49 37 37 37 41 00 00 00 00 00 00 00 00 00 00 49 37 37 37 41
49 35 35 35 35 37 37 37 37 37 37 37 37 37 37 35 35 35 35 41
57 00 00 00 00 49 35 35 35 33 33 35 35 35 41 00 00 00 00 57
57 00 00 00 00 57 00 00 00 49 41 00 00 00 57 00 00 00 00 57
57 00 00 00 00 57 00 53 37 33 33 37 45 00 57 00 00 00 00 57
57 00 00 00 00 57 00 51 35 35 35 35 43 00 57 00 00 00 00 57
57 00 00 53 37 41 00 00 00 00 00 00 00 00 49 37 45 00 00 57
57 00 00 49 33 35 39 39 39 39 39 39 39 39 35 33 41 00 00 57
57 00 00 49 41 00 00 00 00 00 00 00 00 00 00 49 41 00 00 57
57 00 00 49 35 39 39 39 45 00 00 53 39 39 39 35 41 00 00 57
81 37 37 41 00 00 00 00 57 00 00 57 00 00 00 00 49 37 37 73
49 35 35 35 39 45 00 00 57 00 00 57 00 00 00 53 35 35 35 41
57 00 00 00 00 49 45 00 57 00 00 57 00 00 00 57 00 00 00 57
49 37 45 00 00 49 41 00 49 37 37 41 00 00 00 57 00 00 00 57
51 35 41 00 00 49 35 37 35 35 35 35 39 37 39 41 00 53 39 43
17 00 57 00 00 57 00 57 00 00 00 00 00 57 00 57 00 57 00 09
53 39 35 39 39 43 00 51 39 45 00 53 39 43 00 51 39 35 39 45
57 00 00 00 00 00 00 00 00 57 00 57 00 00 00 00 00 00 00 57
51 39 39 39 39 39 39 39 39 35 39 35 39 39 39 39 39 39 39 43